99999999
1|0|500
1|50|500
1|100|500
1|150|500
1|200|500
1|500|500
1|550|500
1|600|500
1|650|500
1|200|200
1|250|200
1|300|200
1|350|200
1|400|200
1|800|550
1|850|550
1|900|550
1|950|550
1|1000|550
1|700|50
1|750|50
1|800|50
1|850|50
1|750|800
1|800|800
1|850|800
1|900|800
1|300|900
1|350|900
1|400|900
1|450|900
1|500|900
1|1000|300
1|1050|300
1|1100|300
1|1150|300
1337|10000|10000
11|500|300
0|50|300