0|400|200
1|0|550
1|50|550
1|100|550
1|150|550
1|200|550
1|250|550
1|300|550
1|350|550
1|400|550
1|450|550
1|500|550
1|550|550
1|600|550
1|650|550
1|700|550
1|750|550
1|800|550
1|850|550
1|900|550
1|950|550
1|0|0
1|50|50